…	...
&	y
lt	último tweet
....	...
vos	vosotros
sos	sois
amp	y
vs	versus
fav	favorito
cr7	Cristiano_Ronaldo
qe	que
.....	...
ok	vale
see	134
q	que
tenes	teneis
nose	no se
tw	Twitter
na	nada
lol	jaja
app	aplicación
gym	gimnasio
pls	por favor
x	por
profe	profesor
fb	Facebook
ke	que
queres	quieres
chau	chao
orto	ano
lpm	la puta madre
epn	Enrique_Peña_Nieto
seguime	sigueme
finde	fin de semana
......	...
ahre	vale
porfavor	por favor
md	mensaje directo
sept	septiembre
cn	con
cel	celular
pq	porque
novatdt	novatada
bs	beso
km	kilómetro
sr	señor
sep	septiembre
tl	timeline
aveces	a veces
omg	dios mio
porfa	por favor
dr	doctor
enserio	en serio
hdp	hijo de puta
porq	porque
nooo	no
pdte	pendiente
ami	a mi
hd	alta definición
wpp	Whatsapp
celu	celular
wsp	Whatsapp
besitos	besos
tenés	tienes
esque	es que
amoo	amo
gim	gimnasio
tranqui	tranquilo
1er	primer
wtf	que coño
hrs	horas
tods	todos
sisi	si
xf	por favor
xq	porque
bn	bien
........	...
besito	beso
wp	Whatsapp
oct	octubre
plis	por favor
uni	universidad
vip	persona muy importante
querés	quieres
pte	presidente
decile	dile
tkm	te quiero mucho
pto	puto
